10.oZ
.o.o.o....
o..oo...o.
.........o
...oo....o
.o.o......
.o....o..o
....o.....
..........
ooo.......
........oo
